{
    "mazes_without_loops": [
        [
        [8,  10, 2,  2,  10, 7,  13, 2,  2,  7,  13, 10, 2,  10, 2,  7 ],
        [1,  7,  9,  5,  11,  5,  10, 6,  9,  5,  10, 10, 6,  12, 9,  9 ],
        [9,  9,  9,  12, 12,  8,  10, 7,  1,  10, 10, 10, 7,  9,  9,  9 ],
        [9,  9,  9,  9,  9,  5,  11, 9,  9,  8,  10, 7,  9,  9,  9,  9 ],
        [9,  9,  5,  3,  5,  10, 10, 3,  9,  9,  8,  6,  5,  6,  9,  9 ],
        [9,  5,  7,  14, 8,  10, 10, 6,  9,  14, 5,  10, 10, 10, 6,  9 ],
        [9,  12, 5,  10, 6,  12, 8,  11, 14, 8,  2,  11, 8,  10, 10, 3 ],
        [9,  1,  10, 10, 10, 6,  1,  2,  7,  9,  9,  8,  6,  8,  10, 3 ],
        [9,  9,  8,  2,  2,  10, 6,  5,  6,  9,  5,  6,  12, 9,  12, 9 ],
        [9,  5,  6,  9,  9,  13, 7,  8,  7,  5,  10, 7,  9,  1,  6,  9 ],
        [5,  2,  10, 6,  5,  7,  9,  9,  1,  11, 8,  6,  1,  6,  8,  3 ],
        [8,  6,  8,  7,  8,  3,  1,  6,  1,  7,  9,  8,  6,  12, 9,  14],
        [9,  8,  6,  5,  6,  1,  6,  13, 3,  5,  4,  4,  10, 6,  5,  7 ],
        [9,  5,  7,  8,  7,  5,  7,  8,  4,  10, 10, 10, 7,  8,  10, 6 ],
        [5,  11, 9,  9,  1,  11, 9,  5,  7,  8,  10, 7,  9,  5,  10, 7 ],
        [13, 10, 6,  14, 5,  10, 4,  10, 6,  5,  11, 5,  4,  10, 10, 6 ]
        ]
    ]
}